111111111111111111111111111111111111111
1                                     1
1                                     1
1              33                     1
1            33                       1
1          22           22            1
1            22       22  33          1
1              3344433      33        1
1                45                   1
1      33      3344433                1
1        33  22       22              1
1          22           22            1
1                     33              1
1                   33                1
1                                     1
1                                     1
111111111111111111111111111111111111111